子 : 一 了		
月 : 冂 二		
金 : 𠆢 王 丷	
車 : 一 日 十	
山 : 凵 ｜		
行 : 彳 二 亅	
西 : 一 儿 囗	
小 : 亅 八		
五 : 一 ｜ ユ	
生 : 𠂉 土		
食 : 𠆢 丶 艮	
大 : 一 人		
高 : 亠 冂 口 口
土 : 十 一		
見 : 儿 目
右 : 一 ノ 口	
語 : 言 五 口	
校 : 木 亠 父	
間 : 門 日		
円 : 亠 冂		
分 : ハ 刀		
下 : 一 卜		
国 : 囗 王 丶	
中 : ｜ 口		
時 : 日 土 寸	
天 : 一 大		
七 : ノ 乚		
北 : 匕 爿		
学 : ⺌ 冖 一 了
前 : 丷 一 月 ⺉
午 : 𠂉 十		
読 : 儿 冖 士 言
休 : ⺅ 木		
名 : 口 夕		
東 : 木 田		
書 : 日 聿		
何 : ⺅ 一 口 亅
気 : 丶 ノ 气	
男 : 田 力		
四 : 儿 囗		
聞 : 耳 門		
千 : ノ 十		
左 : 一 ノ 工	
半 : 丷 一 十	
電 : 乚 雨 日	
出 : 凵 山		
本 : 一 木		
上 : 一 卜		
来 : 一 丷 木	
六 : 亠 ハ		
話 : 言 ノ 十 口
後 : 夂 幺 彳	
南 : 十 冂 丷 干
百 : 一 白		
友 : 一 ノ 又	
毎 : 𠂉 毋		
外 : 夕 卜		
先 : ノ 土 儿	
三 : 一 二				